Gg, Rr, Hh, Hh, Hh, Hh, Hh, Hh, Hh, Rr, Rr, Gg, Gg, Gg, Gs^Fp, Gs^Fp, Gg, Gg, Gg, Gs^Fp, Gs^Fp, Gs^Fp
Gg, Gs^Fp, Gs^Fp, Hh, Hh, Hh, Hh, Hh, Mm, Mm, Mm, Rr, Rr, Gs^Fp, Gg^Ve, Gs^Fp, Gg, Gg, Gg, Gs^Fp, Gs^Fp, Gs^Fp
Hh, Hh, Hh, Mm, Mm, Mm, Mm, Mm, Mm, Mm, Mm, Hh, Gs^Fp, Rr, Gs^Fp, Gs^Fp, Gg, Gg, Gs^Fp, Gs^Fp, Hh, Hh
Hh, Mm, Mm, Mm, Mm, Mm, Mm, Mm, Mm, Mm, Mm, Hh, Ch, Ch, Ch, Gs^Fp, Gg, Gg, Hh, Mm, Mm, Rr
Mm, Mm, Ww, Ww, Ww, Ww, Mm, Mm, Mm, Mm, Mm, Hh, Ch, 2 Kh, Ch, Rr, Rr, Gg, Hh, Mm, Mm, Mm
Mm, Ww, Ww, Ww, Ww, Ww, Ww, Mm, Mm, Mm, Hh, Hh, Gs^Fp, Ch, Hh, Hh, Rr, Gg, Gg, Hh, Mm, Mm
Mm, Mm, Ww, Ww, Ww, Ww, Ww, Ww, Gg, Gg, Gg, Gg, Rr, Rr, Gg, Gg, Gg, Rr, Hh, Mm, Mm, Mm
Mm, Mm, Mm, Ww, Ww, Ww, Hh, Gg, Gg, Gg, Gg, Gg, Rr, Gg, Gg, Gg, Gg, Rr, Hh, Mm, Mm, Mm
Rr, Mm, Mm, Ww, Ww, Mm, Hh, Gg, Gg, Gg, Gg, Gg, Gg, Rr, Rr, Gg, Gg, Rr, Rr, Hh, Hh, Hh
Mm, Rr, Rr, Mm, Ww, Mm, Hh, Gs^Fp, Gg, Gg, Gg, Gg, Gg, Gs^Fp, Rr, Gg, Gs^Fp, Gs^Fp, Gs^Fp, Rr, Gg, Gg
Mm, Mm, Mm, Rr, Ww^Bw\, Mm, Hh, Gs^Fp, Rr, Gg, Gg, Gg, Gg, Gs^Fp, Rr, Gg, Gg, Gg, Hh, Rr, Gg, Gg
Mm, Mm, Mm, Hh, Ww, Rr, Rr, Rr, Gs^Fp, Rr, Rr, Gg, Gg, Gs^Fp, Rr, Ds, Hh, Hh, Gg, Rr, Rr, Gg
Mm, Mm, Mm, Hh, Mm, Mm, Hh, Hh, Gg^Ve, Gs^Fp, Gg, Rr, Gg, Gs^Fp, Rr, Hh, Hh, Hh, Gg, Gg, Rr, Gg
Hh, Mm, Mm, Mm, Hh, Hh, Hh, Gs^Fp, Gs^Fp, Gs^Fp, Gg, Rr, Gs^Fp, Gs^Fp, Rr, Hh, Mm, Hh, Gs^Fp, Gg, Rr, Gg
Hh, Mm, Mm, Mm, Mm, Hh, Hh, Gs^Fp, Gs^Fp, Gs^Fp, Gg, Rr, Gs^Fp, Gg, Rr, Hh, Mm, Hh, Gs^Fp, Rr, Gg^Vh, Gg
Hh, Mm, Mm, Mm, Mm, Hh, Hh, Gs^Fp, Gs^Fp, Gs^Fp, Gg, Rr, Rr, Gg^Vh, Gg, Ch, Ch, Ch, Gs^Fp, Rr, Gg, Gg
Mm, Mm, Mm, Mm, Mm, Mm, Hh, Gs^Fp, Gs^Fp, Gs^Fp, Gg, Gg, Gg, Rr, Rr, Ch, 1 Kh, Ch, Gs^Fp, Rr, Gs^Fp, Gg
Mm, Mm, Mm, Mm, Mm, Mm, Mm^Vhh, Hh, Gs^Fp, Gs^Fp, Gg, Gg, Gg, Gg, Gg, Rr, Ch, Gs^Fp, Gs^Fp, Rr, Rr, Gs^Fp
Hh, Mm, Mm, Mm, Mm, Mm, Mm, Gs^Fp, Gs^Fp, Gg, Gg, Hh, Hh, Gg, Gg, Rr, Rr, Gg, Gs^Fp, Gs^Fp, Gs^Fp, Rr
Gg, Mm, Mm, Mm, Mm, Mm, Mm, Hh, Hh, Hh, Hh, Hh, Hh, Hh, Gs^Fp, Gg, Rr, Gg, Gg, Gs^Fp, Gg, Rr
Hh, Hh, Mm, Mm, Mm, Mm, Hh, Hh, Hh, Hh, Hh, Hh, Hh, Gg, Gg, Gg, Rr, Gg, Gg, Gg, Rr, Rr
Aa, Ha, Mm, Mm, Mm, Hh, Hh, Hh, Rr, Hh, Hh, Mm, Rr, Gg, Gg, Gg, Rr, Gg, Rr, Gg, Rr, Gs^Fp
