Hh, Mm, Mm, Hh, Hh, Gs^Fp, Rr, Gg, Gg, Gg, Ds, Ds, Ds, Ds, Ds, Ww, Ds, Ds, Rr, Gg, Gg, Gg, Gg, Gg
Hh, Mm, Mm, Mm, Hh, Gs^Fp, Rr, Gg, Gg, Gg, Ds, Ds, Ds, Ds, Ww, Ww, Ww, Ds, Rr, Gg, Gg^Vh, Gg, Gg, Gg
Mm, Mm, Mm, Hh, Hh, Hh, Rr, Gg, Gg, Gg, Gg, Gg, Ds, Ds, Ds, Ww, Ds, Gg, Rr, Gg, Gg, Gg, Aa, Aa
Hh, Hh, Hh, Hh, Hh, Hh, Rr, Gs^Fp, Gs^Fp, Gg, Gg, Ds, Gs^Fp, Ds, Ds, Ds, Rr, Ch, Ch, Ch, Gg, Gg, Aa, Aa
Hh, Hh, Gg, Hh, Gg, Rr, Gs^Fp, Gg^Ve, Gs^Fp, Gs^Fp, Gs^Fp, Gs^Fp, Rr, Gs^Fp, Rr, Rr, Gs^Fp, Ch, 2 Kh, Ch, Gg, Gg, Aa, Aa
Gg, Gg, Gg, Gg, Gg^Vh, Rr, Gs^Fp, Gs^Fp, Gg, Gs^Fp, Gs^Fp, Rr, Gg^Vh, Rr, Gg, Gs^Fp, Gg, Gg, Ch, Gg, Gg, Gg, Gg, Gg
Aa, Aa, Aa, Aa, Gg, Rr, Gs^Fp, Gs^Fp, Gs^Fp, Gs^Fp, Rr, Rr, Gg, Gg, Gg, Gg, Rr, Rr, Gs^Fp, Gs^Fp, Gs^Fp, Gg, Gg, Gg
Aa, Aa, Aa, Aa, Gg, Rr, Gg, Gg, Gs^Fp, Gs^Fp, Rr, Gg, Gg, Gg, Gg, Gg, Rr, Gs^Fp, Gs^Fp, Gg^Ve, Gs^Fp, Gs^Fp, Gg, Gg
Gg, Gg, Aa, Aa, Rr, Rr, Rr, Rr, Rr, Rr, Gg, Gg, Gg, Gg, Gg, Rr, Gs^Fp, Gs^Fp, Gs^Fp, Gs^Fp, Gs^Fp, Gs^Fp, Gs^Fp, Gg
Gg, Gg, Gg, Aa, Aa, Gg, Rr, Gg, Gg, Gg, Gg, Gg, Gg, Gg, Gg, Rr, Gs^Fp, Gs^Fp, Gs^Fp, Gs^Fp, Gs^Fp, Gs^Fp, Gg, Gg
Gg, Gg, Rr, Rr, Aa, Rr, Gg, Gg, Gg, Gg, Gs^Fp, Gs^Fp, Gg, Gg, Gg, Rr, Gs^Fp, Gg, Gg, Gs^Fp, Gs^Fp, Gs^Fp, Gs^Fp, Gg
Gs^Fp, Gs^Fp, Rr, Gg, Gg, Rr, Gg, Gg, Gg, Gs^Fp, Gg^Ve, Gs^Fp, Gs^Fp, Gg, Gg, Rr, Gs^Fp, Gs^Fp, Gs^Fp, Gs^Fp, Gs^Fp, Gs^Fp, Gs^Fp, Gs^Fp
Gs^Fp, Gs^Fp, Rr, Gs^Fp, Rr, Rr, Gg, Gs^Fp, Gs^Fp, Gs^Fp, Gs^Fp, Gs^Fp, Gg^Ve, Gs^Fp, Gg, Rr, Gg, Gs^Fp, Gs^Fp, Gs^Fp, Gs^Fp, Gs^Fp, Gs^Fp, Gs^Fp
Gg, Gg, Rr, Gs^Fp, Rr, Gg, Gs^Fp, Gs^Fp, Gs^Fp, Gg, Gs^Fp, Gs^Fp, Gs^Fp, Gg, Gg, Rr, Gg, Gg, Gg, Gg, Gg, Gg^Ve, Gs^Fp, Gs^Fp
Gs^Fp, Gg, Rr, Gs^Fp, Gs^Fp, Rr, Gs^Fp, Gs^Fp, Gs^Fp, Gs^Fp, Gs^Fp, Gs^Fp, Gs^Fp, Gs^Fp, Gs^Fp, Rr, Gg, Gg, Gg, Gg, Gg, Gs^Fp, Gg, Gg
Gs^Fp, Gs^Fp, Rr, Ch, Ch, Ch, Gg, Gs^Fp, Gs^Fp, Gs^Fp, Gs^Fp, Gs^Fp, Gs^Fp, Gs^Fp, Gs^Fp, Rr, Gg, Hh, Hh, Hh, Hh, Gg, Gg, Gg
Gs^Fp, Gs^Fp, Rr, Ch, 3 Kh, Ch, Gg, Gs^Fp, Gs^Fp, Gs^Fp, Gs^Fp, Gs^Fp, Gs^Fp, Gs^Fp, Rr, Rr, Gg, Hh, Ww, Ww, Hh, Gg, Gg, Aa
Gg, Gg, Rr, Rr, Ch, Gg, Gs^Fp, Gs^Fp, Gs^Fp, Gs^Fp, Gs^Fp, Gs^Fp, Gs^Fp, Gs^Fp, Rr, Gg, Hh, Ww, Ww, Ww, Hh, Gg, Gg, Aa
Gg, Rr, Gs^Fp, Rr, Gg, Gs^Fp, Gg, Gg, Gg, Gg, Gg, Gs^Fp, Gs^Fp, Gg, Rr, Gg, Ww, Ww, Ww, Ww, Ww, Ww, Gg, Aa
Gg, Rr, Gg^Ve, Rr, Gg, Gg, Gg, Gg, Gg, Gg, Gg, Gs^Fp, Gs^Fp, Gg, Rr, Gg^Vh, Ww, Ww, Ww, Ww, Ww, Gg, Gg, Gg
Rr, Rr, Rr, Rr, Gg, Gg, Gg, Aa, Gg, Gg, Gg, Gg, Gg, Gg, Rr, Gg, Hh, Ww, Ww, Ww, Ww, Gg, Aa, Aa
Aa, Aa, Rr, Gg, Gg, Aa, Aa, Gg, Gg, Gg, Gg, Gg, Gg^Vh, Rr, Gg, Gg, Hh, Hh, Hh, Ww, Gg, Gg, Gg, Gg
Aa, Aa, Rr, Gg, Gg, Aa, Aa, Aa, Gg, Gg, Gg, Gg, Rr, Rr, Gg, Gg, Hh, Mm, Hh, Hh, Gg, Gg, Gg, Gg
Aa, Aa, Aa, Aa, Aa, Aa, Aa, Aa, Gg, Gg, Rr, Rr, Gs^Fp, Gg, Gg, Hh, Hh, Hh, Hh, Hh, Gg, Gg, Gs^Fp, Gs^Fp
Rr, Rr, Gg, Gg, Gg, Gg, Gg, Gg, Gg, Aa, Aa, Gg, Gg, Gg, Gg, Hh, Hh, Hh, Hh, Hh, Gg, Gg, Gs^Fp, Gs^Fp
Rr, Gg, Gg, Gg, Gg, Gg, Gg, Gg, Gg, Gg, Rr, Aa, Gg, Gg, Gg, Gg, Hh, Hh, Hh, Hh, Gg, Gg, Gs^Fp, Gs^Fp
Gg, Rr, Gg, Gg, Gg, Gg, Gg, Gg, Gg, Gg, Rr, Gg, Gg, Gg, Gg, Gg, Hh, Hh, Hh, Hh, Gs^Fp, Gs^Fp, Gs^Fp, Gs^Fp
Gg, Rr, Rr, Gg, Gg, Gg, Gg, Gg, Ww, Gg^Vh, Gg, Rr, Rr, Gg, Gs^Fp, Gs^Fp, Hh, Hh, Hh, Hh, Gs^Fp, Gg, Gg, Gs^Fp
Gg, Gs^Fp, Rr, Gg, Gg, Gg, Gg, Ww, Ww, Ww, Gg, Gg, Rr, Gg, Gs^Fp, Gs^Fp, Gs^Fp, Hh, Hh, Gs^Fp, Gs^Fp, Gs^Fp, Gg^Ve, Gs^Fp
Gs^Fp, Gs^Fp, Gg, Rr, Gg^Vh, Ww, Ww, Ww, Ww, Ww, Gs^Fp, Gg, Rr, Gs^Fp, Gs^Fp, Gg^Ve, Gs^Fp, Gs^Fp, Hh, Hh, Hh, Gs^Fp, Gs^Fp, Gs^Fp
Gs^Fp, Gs^Fp, Gg, Rr, Gg, Gg, Ww, Ww, Ww, Ww, Ww, Gs^Fp, Rr, Gs^Fp, Gs^Fp, Gs^Fp, Gs^Fp, Hh, Hh, Hh, Hh, Hh, Hh, Hh
Gs^Fp, Gs^Fp, Gg, Rr, Gg, Gg, Gs^Fp, Ww, Ww, Ww, Gg^Ve, Rr, Gs^Fp, Gs^Fp, Gg, Gs^Fp, Gs^Fp, Hh, Hh, Hh, Hh, Hh, Hh, Gg
Gs^Fp, Gs^Fp, Rr, Rr, Gg, Gg, Ww, Ww, Ww, Ww, Rr, Rr, Gg, Gg, Gg, Gg, Gg, Gs^Fp, Hh, Hh, Hh, Hh, Gg, Gg
Gs^Fp, Gs^Fp, Rr, Gg, Gg, Gg, Ww, Ww, Ww, Rr, Gg, Gg, Gg, Gg, Gg^Vh, Gg, Gg, Gs^Fp, Hh, Hh, Hh, Gg, Gg, Gg
Gs^Fp, Gs^Fp, Rr, Gg, Gg, Gg^Vh, Ww, Ww, Rr, Rr, Gg, Gg, Gg, Gg, Gg, Gg, Gg, Gs^Fp, Gg, Gg, Gg, Gg, Gg, Gg
Gs^Fp, Rr, Gg, Ch, Ch, Ch, Ww, Gg, Rr, Gg, Gg, Gg, Gg, Gg, Gg, Gg, Gg, Gg, Gg, Gg, Hh, Hh, Gg^Vh, Gg
Gg, Rr, Gs^Fp, Ch, 1 Kh, Ch, Rr, Rr, Gg, Gg, Gg, Gg, Gg, Gg, Gg, Gg, Gg, Gg, Aa, Ha, Hh, Hh, Hh, Gg
Gs^Fp, Rr, Gg, Gs^Fp, Ch, Rr, Gs^Fp, Gg, Gg, Gg, Gg, Gg, Gg, Gg, Gg, Gg, Gg, Gg, Aa, Ha, Hh, Hh, Hh, Gg
Gs^Fp, Rr, Rr, Gs^Fp, Gs^Fp, Gs^Fp, Gs^Fp, Gg, Gg, Gg, Aa, Gg, Gg, Gg, Gs^Fp, Gg, Gg, Gg, Aa, Aa, Hh, Hh, Hh, Hh
Gs^Fp, Gg, Gs^Fp, Rr, Rr, Gs^Fp, Gs^Fp, Gg, Gg, Gg, Aa, Gg, Gg, Gg, Gg, Gs^Fp, Gg, Gg, Gg, Gg, Hh, Hh, Hh, Hh
Gs^Fp, Gg^Ve, Gs^Fp, Gg, Gs^Fp, Rr, Rr, Gg, Gg^Vh, Gg, Aa, Gg, Gg, Gg, Gg^Vh, Gg, Gg, Gg, Gg, Gg, Hh, Hh, Hh, Hh
Ss, Gs^Fp, Gg, Gg, Gg, Gg, Gg, Rr, Gg, Gg, Gg, Gg, Gg, Gg, Gg, Gg, Gg, Gg, Gg, Gg, Gg, Hh, Hh, Hh
