Mm, Aa, Aa, Gg, Gg, Gg, Rr, Rr, Gg, Gg, Gg, Gs^Fp, Gs^Fp, Gs^Fp, Gg, Gg, Gs^Fp, Gs^Fp, Gg, Hh, Hh, Mm, Mm, Ww, Ww, Ww
Ha, Ha, Aa, Gg, Gg, Gg, Rr, Gg, Gg, Gg, Gg, Gs^Fp, Gs^Fp, Gs^Fp, Gs^Fp, Gg, Gg^Ve, Hh, Hh, Hh, Hh, Mm, Ww, Ww, Ww, Ww
Ha, Ha, Aa^Fpa, Gg, Rr, Rr, Gg, Gs^Fp, Gs^Fp, Gg, Gg, Gg, Gg, Gg, Gs^Fp, Gs^Fp, Gs^Fp, Gg, Hh, Ss, Ww, Ww, Ww, Ww, Ww, Ww
Aa, Aa, Aa^Fpa, Ch, Ch, Ch, Gs^Fp, Gs^Fp, Gs^Fp, Gs^Fp, Gg, Gg, Gg, Gg, Gg^Vh, Gs^Fp, Gg, Gg, Gg, Ss, Ss, Ss, Ss, Ww, Ww, Gs^Fp
Gg, Aa, Aa^Fpa, Ch, 4 Kh, Ch, Rr, Gg^Ve, Gs^Fp, Gs^Fp, Gg, Gg, Gg, Gg, Gg, Gg, Gg, Gg, Gg, Ch, Ch, Ch, Ss, Ww, Ww, Ww
Rr, Aa, Ch, Ch, Ch, Hh, Gs^Fp, Rr, Rr, Gs^Fp, Gg, Gg, Aa, Aa, Aa, Aa, Aa, Gg, Gg, Ch, 2 Kh, Ch, Gs^Fp, Ww, Gg^Ve, Gs^Fp
Rr, Aa, Aa, Gg, Gg, Gg, Gs^Fp, Gs^Fp, Gs^Fp, Rr, Gg, Ds, Aa, Aa^Fpa, Aa, Ds, Gg, Gg, Ch, Ch, Ch, Gg, Gg, Gg, Gs^Fp, Gs^Fp
Rr, Aa, Aa, Aa, Gg, Hh, Gg, Gs^Fp, Gs^Fp, Rr, Gg, Gg, Aa, Aa^Fpa, Aa, Gg, Gg, Gg, Gg, Gg, Gg, Rr, Gg, Gs^Fp, Gs^Fp, Gs^Fp
Rr, Gg, Gg, Gg, Gg, Gg, Hh, Gs^Fp, Gg, Rr, Gg, Gg, Gg, Aa, Aa, Gg, Gg, Gg, Gg, Gg, Rr, Rr, Gg, Hh, Hh, Gs^Fp
Gg, Gg, Gg, Gg, Gg, Gg, Gg, Hh, Gg, Rr, Rr, Gg, Gg, Aa, Aa, Gg, Gg, Gg, Gg, Gg^Vh, Rr, Hh, Hh, Hh, Hh, Hh
Gg, Gg, Gg, Gg, Gg, Gg, Hh, Hh, Hh, Hh, Hh, Rr, Rr, Aa, Aa, Gg, Gg, Gg, Gg, Rr, Gg, Hh, Hh, Hh, Hh, Hh
Gg, Gg, Gg, Gg, Gll^Fp, Hh, Hh, Mm, Mm, Mm, Mm, Hh, Gg, Rr, Rr, Gg, Gg, Gg, Rr, Rr, Gg, Gs^Fp, Hh, Hh, Gg, Gg
Gg, Gg, Gll^Fp, Gg, Gll^Fp, Gg, Hh, Mm, Mm, Mm, Mm, Mm, Hh, Gg, Rr, Gg, Gg, Gg, Rr, Gs^Fp, Gs^Fp, Gs^Fp, Gg, Hh, Gg, Gg
Gg, Gg, Gll^Fp, Gll^Fp, Gg, Gg, Hh, Mm, Mm, Mm, Mm, Mm, Hh, Ww, Gg, Rr, Gg, Gg, Rr, Gg^Vh, Gs^Fp, Gs^Fp, Gg, Gg, Gg, Gg
Gg, Gll^Fp, Gll^Fp, Gg, Gg, Gg, Hh, Mm, Mm, Mm, Ww, Mm, Ww, Ww, Gg^Vh, Rr, Rr, Rr, Ds, Ds, Gg, Gs^Fp, Gs^Fp, Gs^Fp, Gs^Fp, Gs^Fp
Hh, Gll^Fp, Hh, Gg, Gg, Gg, Aa, Aa^Fpa, Ha, Mm, Ww, Ww, Ww, Ww, Ww, Gg, Rr, Rr, Ds, Ds, Ds, Ds, Gs^Fp, Gs^Fp, Gs^Fp, Gs^Fp
Gg, Hh, Hh, Gg, Gg, Gg, Aa, Ha, Mm, Mm^Vhh, Ww, Ww, Ww, Ww, Ww, Rr, Gg, Rr, Ds, Ds, Ds, Ds, Gg, Gg, Gg, Gs^Fp
Gg, Gg, Hh, Gg, Gg, Gg, Aa, Gg, Gg, Hh, Ww, Ww, Ww, Ww, Gg^Vh, Rr, Gg, Rr, Gg, Ds, Gg, Gg, Gg, Gg, Gg, Gs^Fp
Gg, Gg, Gg, Gg, Gg, Gg, Gg, Gg, Gg, Hh, Mm, Mm, Mm, Ww, Ss, Rr, Rr, Rr, Rr, Gg, Gg, Aa, Aa, Gg, Gg, Gs^Fp
Gg, Gg, Gg, Gg, Gg, Gg, Gg, Gg, Gg, Hh, Hh, Mm, Mm, Ss, Hh, Gs^Fp, Rr, Gg, Rr, Gg, Gg, Gg, Aa, Gg, Gg, Gg
Aa, Aa, Gg, Gg, Gg, Gg, Gg, Gs^Fp, Gs^Fp, Hh, Hh, Mm, Mm, Mm, Hh, Gs^Fp, Rr, Gg, Rr, Gg, Gg, Gg, Gg, Gg, Gg, Gs^Fp
Gg, Gg, Gg, Gg, Gg, Gg, Gs^Fp, Gs^Fp, Gs^Fp, Hh, Mm, Mm, Mm, Mm, Hh, Rr, Gg, Gs^Fp, Gg^Ve, Rr, Rr, Gg, Gg, Gg, Gs^Fp, Gs^Fp
Ww, Gg, Gg, Gs^Fp, Gs^Fp, Gs^Fp, Gs^Fp, Gg^Ve, Gs^Fp, Hh, Mm, Mm, Mm, Hh, Hh, Rr, Gg, Gs^Fp, Gs^Fp, Gs^Fp, Rr, Gg, Gg, Gg, Gg, Ww
Ww, Gs^Fp, Gg, Gg, Gg, Gs^Fp, Gs^Fp, Gs^Fp, Aa^Fpa, Hh, Mm, Mm, Mm, Hh, Gg, Rr, Rr, Gg, Gg, Gg, Rr, Gs^Fp, Gg, Gg, Gg, Gg
Ww, Hh, Hh, Gg, Gg, Gg, Gs^Fp, Gs^Fp, Gs^Fp, Aa^Fpa, Hh, Mm, Mm, Hh, Gs^Fp, Gs^Fp, Rr, Gg, Gg, Gg, Rr, Gg, Gg, Gg, Gg, Gg
Ww, Mm, Hh, Hh, Hh, Gg, Gs^Fp, Gg^Ve, Gs^Fp, Aa^Fpa, Gs^Fp, Gs^Fp, Gs^Fp, Gs^Fp, Gg^Ve, Rr, Gg, Gg, Gg, Gg, Rr, Gg, Gg, Gg, Gg, Gg
Ww, Ww, Ww, Mm, Hh, Hh, Gs^Fp, Gs^Fp, Gs^Fp, Gs^Fp, Gg, Gg, Gg, Gs^Fp, Gg, Rr, Gg, Gg, Gg, Gg, Rr, Gg, Gg, Gg, Gg, Gg
Ww, Ww, Ww, Mm, Hh, Hh, Gg, Gg, Gg, Gg, Gg, Gg, Gg, Gg, Gg, Rr, Gg^Vh, Gg, Gg, Gg, Rr, Gg, Gs^Fp, Gs^Fp, Gg, Gs^Fp
Ww, Ww, Ww, Mm, Gg, Gg, Gg, Gg, Gg, Gg, Gg, Gg, Gg, Gg, Gg, Rr, Gg, Gg, Gg, Ch, Ch, Ch, Gs^Fp, Gs^Fp, Gs^Fp, Gs^Fp
Ww, Ww, Mm, Hh, Gg, Gg, Gg, Aa, Aa, Gg, Gg, Gg, Gg, Gg, Gg, Rr, Gg, Gg, Rr, Ch, 3 Kh, Ch, Gs^Fp, Gs^Fp, Gs^Fp, Gg
Ww, Hh, Hh, Hh, Gg, Gg, Gg, Gg, Aa, Aa, Gg, Gg, Gg, Gg, Gg^Vh, Rr, Gg, Gg, Ch, Ch, Ch, Rr, Gg, Gs^Fp, Gs^Fp, Gg
Gg, Gg, Gg, Gg, Gg, Aa, Aa, Aa, Aa^Fpa, Aa, Gg, Gg, Gg, Gg, Ds, Rr, Rr, Rr, Gg, Gg, Rr, Rr, Gg, Gs^Fp, Gg, Gg
Ww, Gg, Gg, Gg, Gg, Aa, Aa, Aa^Fpa, Aa, Aa, Gg, Gg, Gg, Gg, Gg, Gg, Gg, Gg, Rr, Rr, Gs^Fp, Gs^Fp, Gs^Fp, Gs^Fp, Gg, Gg
Gs^Fp, Ww, Ww, Gg, Ww, Ai, Aa, Ds, Gg, Gg, Gg, Gg, Gg, Gg, Gg, Gg, Rr, Rr, Gg, Gg, Gg, Gg, Gs^Fp, Gg, Gg^Vh, Gg
Gg, Gs^Fp, Gg, Ww, Gg, Ww, Ww, Ds, Ds, Ds, Gg, Gg, Gg, Gg, Rr, Rr, Gg, Gg, Gg, Gg, Gg, Gg, Gg, Gg, Gg, Gg
Gs^Fp, Gs^Fp, Gs^Fp, Gg, Gg, Gg^Vh, Gg, Ww, Ds, Ds, Ds, Gg, Gg, Rr, Gg, Gg, Gg, Gg, Gg, Gg, Gg, Gs^Fp, Hh, Gs^Fp, Gg, Gg
Gs^Fp, Gg, Gg, Gg, Gg, Gg, Gg, Ds, Ds, Ww, Ds, Gg, Rr, Rr, Gg, Gg, Gg, Gg, Gg, Gg^Vh, Gs^Fp, Hh, Gs^Fp, Hh, Gg, Gg
Gg, Gg, Gg, Gg, Gs^Fp, Gs^Fp, Gg, Gg, Ds, Ww, Ds, Rr, Gg^Vh, Gg, Gg, Gg, Gg, Gg, Gg, Gg, Gs^Fp, Hh, Hh, Hh, Hh, Gg
Rr, Gg, Gg, Gg, Gs^Fp, Ds, Gs^Fp, Gs^Fp, Ds, Ww, Ds, Rr, Gs^Fp, Gg, Gg, Gg, Aa, Gg, Gg, Gg, Gs^Fp, Hh, Hh, Hh, Hh, Gg
Rr, Gg, Gg, Gg, Gs^Fp, Gs^Fp, Gg^Ve, Gs^Fp, Gs^Fp, Ds, Rr, Rr, Gs^Fp, Gg, Gg, Gg, Aa, Gg, Gg, Gg, Gg, Gs^Fp, Gs^Fp, Gs^Fp, Rr, Rr
Rr, Gg, Gg, Gs^Fp, Gs^Fp, Gs^Fp, Gs^Fp, Gs^Fp, Rr, Rr, Ds, Ds, Ds, Ds, Ds, Gg, Aa, Gg, Gg, Gg, Gg, Gg, Gg, Gg, Rr, Hh
Rr, Gg, Gs^Fp, Gs^Fp, Gs^Fp, Gg, Rr, Rr, Gs^Fp, Gs^Fp, Ds, Ds, Ds, Ds, Ds, Gg, Gg, Ds, Ww, Ds, Gg, Gg, Gg, Gg, Rr, Hh
Rr, Gg, Gs^Fp, Gs^Fp, Gg, Rr, Gg, Gg, Gg, Gs^Fp, Gs^Fp, Ds, Ds, Ds, Ds, Gg, Ds, Ww, Ww, Ww, Ww, Gg, Gg, Rr, Gg^Vh, Mm
Gg, Gg, Gs^Fp, Gs^Fp, Rr, Rr, Gg, Gg, Gg, Gg, Gg, Gg, Ds, Ds, Ds, Gs^Fp, Gg, Gs^Fp, Gs^Fp, Gs^Fp, Ww, Ww, Gg^Vh, Rr, Rr, Hh
Gg, Gg, Gg, Ch, Ch, Ch, Gg, Gg, Gg, Gg, Gg, Gg, Gg, Ds, Gg, Gs^Fp, Gs^Fp, Gs^Fp, Gg, Gg, Gs^Fp, Ww, Ww, Gg, Rr, Hh
Gg, Gg, Gg, Ch, 1 Kh, Ch, Gg, Gg, Gg, Aa, Aa, Aa, Gg, Gg, Gg, Gs^Fp, Gs^Fp, Gs^Fp, Gs^Fp, Gs^Fp, Gs^Fp, Gg, Ww, Gg^Vh, Rr, Hh
Aa, Aa, Ch, Ch, Ch, Gg, Gg, Gg, Gg, Aa, Aa, Gg, Gg^Vh, Gg, Gg, Gs^Fp, Hh, Hh, Hh, Gs^Fp, Gg, Gg, Ww^Bw/, Rr, Gg, Gg
Aa, Aa, Gg, Gg, Gg, Gg, Gg, Gg, Gg, Gg, Aa, Gg, Gg, Gg, Gs^Fp, Hh, Mm, Mm, Hh, Gg, Rr, Rr, Ww, Gg, Gg, Hh
Aa, Aa, Aa, Gg, Gg, Gg, Gg^Vh, Hh, Hh, Hh, Hh, Hh, Gg, Gs^Fp, Gs^Fp, Hh, Mm, Hh, Hh, Hh, Rr, Ww, Gg, Gg, Hh, Ww
Rr, Gg, Gg, Gg, Rr, Rr, Rr, Hh, Mm, Mm, Mm, Mm, Gg, Hh, Hh, Hh, Hh, Hh, Gs^Fp, Hh, Rr, Ww, Ww, Ww, Ww, Ww
Gs^Fp, Rr, Rr, Rr, Gg, Gg, Gg, Rr, Rr, Mm, Mm, Mm, Hh, Gg, Hh, Gs^Fp, Gs^Fp, Gs^Fp, Gs^Fp, Gs^Fp, Gs^Fp, Rr, Ch, Ww, Ww, Ww
Gs^Fp, Gs^Fp, Gs^Fp, Gg, Gg, Gg, Hh, Mm, Mm, Rr, Rr, Mm, Gg, Gg, Gg, Gg, Gs^Fp, Gs^Fp, Gg, Gg, Gg, Gs^Fp, Ww, Ww, Ww, Ww
