Irs, Gg, Ch, Gg, Ch, Gg, Ch, Gg, Ch, Gg, Irs
Irs, Ch, Ch, Ch, Ch, Ch, Ch, Ch, Ch, Ch, Irs
Irs, Ch, Icr, Icr, Icr, Ch, Icr, Icr, Icr, Ch, Irs
Irs, Ch, Irs, Icr, Irs, Kh, Irs, Icr, Irs, Ch, Irs
Irs, Ch, Irs, Irs, Irs, Irs, Irs, Irs, Irs, Ch, Irs
Irs, Irs, Irs, Irs, Irs, 1 Irs, Irs, Irs, Irs, Irs, Irs
Irs, Irs, Irs, Irs, Irs, Irs, Irs, Irs, Irs, Irs, Irs
Irs, Irs, Irs, Irs, Cha, Cha, Cha, Irs, Irs, Irs, Irs
Gs, Irs, Gs, Irs, Cha, Kh, Cha, Irs, Gs, Irs, Gs
Gg^Efm, Gg^Efm, Gg^Efm, Gs, Gg, Cha, Gg, Gs, Gg^Efm, Gg^Efm, Gg^Efm
Gg, Gg, Gg, Gg, Gg, Gg, Gg, Gg, Gg, Gg, Gg
